Abe Ease Seize Supports	ABC Sports
Abe Odd Hull Luck Oak	A bottle of Coke
Abe you team arc	A beauty mark
Ace Lip Puff That Hung	A slip of the tongue
Ace Tray Taste Who Dent	A straight A student
Aid Are Crank Loud	A dark rain cloud
Aid Hay Huff Ache Asian	A day of vacation
Aid Ride Hyper	A dry diaper
Ale Of Huff Air	A Love affair
Amos Ooze	A Masseusse
Annex Tin Chunk Hoard	An Extension Cord
Annie Leg Ditto Fish Hull	An elected official
Ape Arrows Uncle As His	A pair of sunglasses
Ask Rude Arrive Her	A Screwdriver
Bat Tree Snot Ink Looted	Batteries not included
Bay beak hot bach	Baby got back
Bowl Egg Head	Bow legged
Canoe key Pace He Grit	Can you keep a secret?
Canoe Key Pass Egret	Can you keep a secret?
Chick He Tub An An Us	Chiquita Bananas
Cohen Peas	Go in peace
Cry Cub Hook	Crack a book
Date Roy Pea Stuns	Detroit Pistons
Dawn dude rugs	Don't do drugs
Day Leofur Rings	Daily Offerings
Deep Rinse Soft Ides	The Prince of Tides
Delete Elmer Made	The little mermaid
Dew Wino Hue	Do I know you?
Dew Ache Who Gulls Urge	Do a Google search
Dish Hippie Slaw Stats He	The ship is lost at sea
Dock Door Rat Kin Sty Hit	Dr. Atkins diet
Double Use He Fee Yields	W.C. Fields
Duet Tomb He Juan Mort I'm	Do It To Me One More Time
Ease Owner Whole	He's on a roll
Egg Aim Much Egg Curse	A game of checkers
Eight He Muff Forces	A team of horses
Eight Weeds Hoot	a tweed suit
Europe Art Tough Fit	You're a part of it
Europe Lay Sore Mine?	Your place or mine?
Europe Ray Tear Owe	You're a prayer away
Eye Mad Alas	I met a lass
Eye Mull of Mush Sheen	I'm a love machine
Eye Needle Ax Eight If	I need a laxative
Fee Limber Raven Huff Toot Rye	Feel I'm brave enough to try
Feet Verb List Her	Fever Blister
Freeze Age Ha! Leak Hood Fell Owe	For he's a jolly good fellow
Fur Chin Ollie Foil	Virgin Olive Oil
Grey ties hats course	Greatest Scores
Hiawatha dean edge van pyre	I was a teenage vampire
Hide Hen Tickled Wins	Identical Twins
High hose hill fray weigh	Hi Ho Silver, away!
hint a few width diva umpire	Interview with a vampire
Hit Sewn Leap Uphill Of	It's only puppy love
Hit Spin Could Form He	It's been good for me
Hit Stop Add	It's too bad
Hive kotter bran nookie	I've got a brand new key
Hoe Pin-Up Hits Depot Lease	Open Up! It's The Police
Hype People Earth Duh Hey	Happy Birthday
Ice Mail Ask Hunk	I smell a skunk
Ike Otcha	I gotcha
Isle Of View	I love you
It Chief Heat	Itchy feet
Jeffgay	JFK
Jog Clay Die Scream	Chocolate Ice Cream
Kitten Scene Gulf Aisle	Get in single file
Know Ozark	Noah's Ark
Koala Deep Rod Ducks	Quality Products
Ladle Rat Rotten Hut	little Red Riding Hood
Law Duff There Inks	Lord of the Rings
Lie Turf Lou Hid	Lighter Fluid
Lit Tell It All Lee	Little Italy
Loaf Meat Hender	Love me Tender
Mare Eek Ate Danish Lee Hole Sin	Mary-kate and Ashley Olsen
Mayor Itch Maiden Evan	Marriage made in heaven
Mine Her Infer Auction	Minor infraction
Moe's Art	Mozart
Mower Thin Nuke Inch Who	More than you can chew
My Kojak Sun	Michael Jackson
Nose Hole Is Sitting	No Soliciting
Noose Raid He Owe	News Radio
Ooze Kid Sing Sand Tough Claws	Who's Kissing Santa Claus
Pe Psim Aks	Pepsi Max
Pea Sank White	Peace and Quiet
Pie Rate Softy Care Hip Been	Pirates of the Carribean
Pier Steers	Pierced ears
Plea stake arrow fit	Please take her off it
Rib Uncut Inks Harem Owe Knee	Ribbon cutting ceremony
Rim Him Birth Owl Limo	Remember The Alamo
Sand Tack Laws	Santa Claus
Sex Yule Hair Is Mint	Sexual harrasment
Space You'll Limp Picks	Special Olympics
These If Hill Wore	The Civil War
Thesis Pine Alt Hap	This is Spinal Tap
Thick awe loved hoot he	The call of duty
Thick Hull Foam Heck Sicko	The Gulf of MeXico
Thigh Sing Gone Thick Ache	The Icing on The Cake
Tis Coal Eighty	Disco Lady
Up Hair Hush Ooze	A Pair Of Shoes
Up He Such Ease	A piece of cheese
Up Hound Hug Round Round	A pound Of Ground Round
Uppers Enough Heist Hand Herds	A person of high standards
Us Her Fair	A surveyor
Watch Choo Ear Nut Washer Tse	What You Hear Not What You Say
Weaker Tool Hater	Week or two later
We Shy Worth Hare	Wish I was there
Weeg lib his neigh sours	Weekly business hours
Went Hurl Hymn Pick Aims	Winter Olympic Games
Wheel Yum Air Ream He	Will You Marry Me
Whole League How	Holy cow
Wide Own Twig Hose Women	Why Don't We Go Swimming
Will Saw Rim Ocean	Wheels are in motion
William Harem He	Will You Marry Me
Wine Grit Ski	Wayne Gretzky
Wok Lie Canny Chip Shun	Walk like an Egyptian
Woodchuck Air Ford Us Hurt	Would you care for dessert?
Yell Hope Hey Jess	Yellow Pages
Yore Luke Ink Hood	You're looking good
Aim Meek Rant	Amy Grant
Elf Habits Hoop	Alphabet Soup
Ape Haul Oath Hurt Dean	Apollo Thirteen
Condo Leaser Ice	Condoleezza Rice
Dawned Hutch Debt Aisle	Don't Touch That Dial
Day Fed Peck Calm	David Beckham
Day Fit Gas City	David Cassidy
Tote Hall Reek Hall	Total Recall
Zola Reek Lips	Solar Eclipse
My Cull Chore Den	Michael Jordan
Sell Your Laugh Hone	Cellular Phone
Made Divorce Pea Whiff Ewe	May The Force Be With You
Jar Lease Ain't Gels	Charlie's Angels
Four Ghetto Fur	Fork It Over
Curls Con Why Held	Girls Gone Wild
Eggs Hearse Sized Hay Lee	Exercise Daily
Ease Sat Theme Hark It	He's At The Market
Kenya Ear Mean How	Can You Hear Me Now?
Key Furs Other Lend	Kiefer Sutherland
Oak And A Duh	O Canada
Bet Turf Oar Kit It	Better Forget It
In Reef Honda	Henry Fonda
Doll May Shuns	Dalmatians
Lass Twill Ant Taste A Mint	Last Will And Testament
Weed Owns Tan Ditch Ants	We Don't Stand A Chance
Wreck You Lure Hoard He Calf	Regular Or Decaf?
Pry Fat Bench A Man	Private Benjamin
Jaw Knee App Bulls Heed	Johnny Appleseed
Kit Tread He Fort Hey Cough	Get Ready For Takeoff
Shook Hurl His Scum	Sugarless Gum
Thief Armor Indeed Hell	The Farmer In The Dell
Abe You Team Arc	A Beauty Mark
Hair Rose Myth	Aerosmith
Warren Peas	War And Peace
Oz Karma Your Wee Nurse	Oscar Mayer Wieners
Thud High Spin Gassed	The Die's Been Cast
Tie Man Dug Hen	Time And Again
Abe Hat Chill Harp Add	A Bachelor Pad
Freeze Age Ha! Leak Hood Fell Owe	For He's A Jolly Good Fellow
Fur Stay Dins Trucked Her	First Aid Instructor
Mist Hearse Hatter Dane Height	Mr. Saturday Night
These Mash Imp Hum Kens	The Smashing Pumpkins
Hollered Hay We Canned	Holiday Weekend
Pea Cup Tease Hope	Pick Up The Soap
Abe Hires Mar Get	A Buyer's Market
Facts Mash Sheen Pay Purr	Fax Machine Paper
Jaw Nan Bah Beak Hen Eighty	John And Bobby Kennedy
Abe Lesson Indy Skies	A Blessing In Disguise
Half Turf I've Oak Lock	After Five O'clock
Pray Parade Shun Age	Preparation H
Aisle Hand Sin Dust Ream	Islands In The Stream
Bay Beach Hemp Ooh	Baby Shampoo
Appears Neigh Full	A Pierced Navel
Boat Hock Sin Check Shuns	Botox Injections
Come Pew Turf High Russ	Computer Virus
Chest Jew Wade Aim In It	Just You Wait A Minute
Caress Peak Reamed Hone Huts	Krispy Kreme Doughnuts
Debts Heaven Dish Hoe	That Seventies Show
Run Hazel Wig Her	Renee Zellweger
Yang Keyed Ooh Dealt Andy	Yankee Doodle Dandy
More Mint Abba Nack Elk Wire	Mormon Tabernacle Choir
Is Bunch Pops Queer Pans	Sponge Bob Square Pants
Eight Hey Blanch Hair	A Table And Chair
Chest Hey Kitty See	Just Take It Easy
Eyed Rink Gay Tour Eight	I Drink Gatorade
Dawn Alt South Hurl Hand	Donald Sutherland
Gnome Ore Deers	No More Tears
Lie Cave Urchin	Like A Virgin
Gasp Earthy Fur End Lee Coast	Casper The Friendly Ghost
Day Demand War Kink	Dead Man Walking
Hi Hand Rye	High And Dry
Abe Aura Her She's Chalk Lit	A Bar Of Hershey's Chocolate
Heart Official Ant Heller Gents	Artificial Intelligence
Saw Fast Abe Abie Spot Hum	Soft As A Baby's Bottom
Yule Height Dub Mile I've	You Light Up My Life
Soon Knees Hide Hup	Sunny Side Up
June Your Ice Cool	Junior High School
Inner Bod Hull Oar Rug Lass	In A Bottle Or Glass?
Mower Lease Hay Fur	Morley Safer
Shirly Huge Chest	Surely You Jest
Theme Hiss Single Ink	The Missing Link
Age Ants Oval I've Dime	A Chance Of A Lifetime
Half Reed Hummed He Canary	Every Tom, Dick And Harry
Thief Huge A Tiff	The Fugitive
Muff Heater Gold	My Feet Are Cold
Says Amy's Treat	Sesame Street
Strain Jazzin' Dean Height	Strangers In The Night
Fur Chin Ollie Foil	Virgin Olive Oil
Free Quaintly As Quest Shuns	Frequently Asked Questions
More Fee Slaw	Murphy's Law
These Moe King Hun	The Smoking Gun
Hopper Tune Hit Teen Ox	Opportunity Knocks
Own Lethal Only	Only The Lonely
Abe Heavy Hub You Tease	A Bevy Of Beauties
Eye Falafel	I Feel Awful
Jaw Neon These Pot	Johnny On The Spot
Pade Sage Hack	Pat Sajak
Hal Leak Off Dare Hone	A League Of Their Own
Oz Temp Hours	Austin Powers
Swede Hans Hour Poke	Sweet And Sour Pork
Sue Think Moss Hodge	Soothing Massage
Tum Eel As Hoarder	Tommy Lasorda
Poe Stitched Ooh	Postage Due
Lewd High Mend Fill Ups	Lou Diamond Phillips
Foyer Ice Sown Lee	For Your Eyes Only
Cusp Helm Ooze Sick	Gospel Music
Eight Wean Gull Any Size	A Twinkle In His Eyes
Huff Oral Heave Glow Fur	A Four-leaf Clover
Mall Tome Heel	Malt-O-Meal
Ran Dumb Max Suck Highness	Random Acts Of Kindness
The Odor Rows Of Felt	Theodore Roosevelt
Weed Hid Dents Tart Thief Higher	We Didn't Start The Fire
Ace Tray Taste Who Dent	A Straight-A Student
En Wipe He Deep Lou	NYPD Blue
Gay Twin Sled	Kate Winslet
Thai Rob Hanks	Tyra Banks
June Heifer Rye Tomb He	You Never Write To Me
Lou Quad Hive Cot	Look What I've Got
Mower Thin Nuke Inch Who	More Than You Can Chew
Raw Key Mound Annoy Stirs	Rocky Mountain Oysters
Tooth Her Mack Her Rain Her	Do The Macarena
Gnat Shin Allen Choir Ore	National Enquirer
Abe Hole Hutch Hip Sand Hip	A Bowl Of Chips And Dip
Ham A Sing Disc Hover He	Amazing Discovery
Lay Dissolve Thin Height	Ladies Of The Night
My Hill Hike Lob	Mile High Club
Say Rum Hush Elk Killer	Sarah Michell Gellar
Twin Keyed Evince	Twinkle Defense
Yore Ache Hunt Rolfe Reek	You're A Control Freak
State Who Their Height	Stay To The Right
Day Vid Carrot Dean	David Carradine
Haste Hat Assemble	A Status Symbol
Mel Walk Hebrews Hers	Milwaukee Brewers
Sin Deal Law Purr	Cyndi Lauper
Damp Obey Floor Eater	Tampa Bay, Florida
Sir Face Ess	Survey Says
Ease Bag Kin These Had Dull	He's Back In The Saddle
Wand Doll Iran Dense Hence	One Dollar And Ten Cents
Sit Jerk Lock	Set Your Clock
Paw Rolfe Eye Owe Lay Shun	Parole Violation
I'm Issues Home Hutch	I Miss You So Much
Finesse Aah! Wheel Yams	Vanessa Williams
Dawn Dutch Mice Tough	Don't Touch My Stuff
Bat Tree Snot Ink Looted	Batteries Not Included
Ease Sung Gopher	He's Hungover
High Dance Eek	Hide And Seek
Maid Fur Reach Hover	Made For Each Other
Pomp Eyelet	Palm Pilot
Thief Act Huff Them Adder	The Fact Of The Matter
Whole Imp Pig Aims	Olympic Games
Tray Sure Aisle Hand	Treasure Island
Police Bees Eerie Us	Please Be Serious
Lee On Hard Odie Cap Rio	Leonardo DiCaprio
Frumps Hero Dues Hicks Tee	From Zero To Sixty
Canoes He Wad Ice He	Can You See What I See?
Eighth Reap Ease Hoot	A Three-Piece Suit
Hugh Essay Tude Hay	USA Today
Mare Itch Prop Owes All	Marriage Proposal
Raw Key Ant Bull Wink Hill	Rocky And Bullwinkle
These Hound Doff Moo Sick	The Sound Of Music
Watts Ford Inner	What's For Dinner
She Cargo Ill Annoy	Chicago Illinois
Eye Ham Width Stew Ped	I Am With Stupid
Gay Duds Hun	Kate Hudson
Joan Hay Myth	Joe Namath
We Knit Train Sip Oars	When It Rains, It Pours
Manna Cue Her	Manicure
Newer Leans Ain'ts	New Orleans Saints
Read Hick Yule Us	Ridiculous
Theme Ask Cough Sore Owe	The Mask Of Zorro
Gnu Your Cassidy	New York City
Holes Ale Pry Says	Wholesale Prices
Eight Up Aware Par Tee	A Tupperware Party
I'm On Stairs Sink	Monsters Inc
Nor Thumb Air Reckon	North American
Sadder Dane Height Fee Fur	Saturday Night Fever
Urine Deem Honey	You're In The Money
Youth Ink York Ooh	You Think You're Cool?
Stay Pulse Enter	Staples Center
Damp Day Shun Eye Lend	Temptation Island
Haystack Up Hank Aches	A Stack Of Pancakes
Mar Can The Knee	Marc Anthony
Peek Nicked Ape Bull	Picnic Table
Dozen May Kenny Cents Tomb He	Doesn't Make Any Sense To Me
Sioux Punk Rack Hearse	Soup And Crackers
Fur Stand Form Host	First And Foremost
Wands Up Pawn Eight I'm	Once Upon A Time
Sym Bell Has Abe He Sea	Simple As A-B-C
Plea Sway Tube Ease Heated	Please Wait To Be Seated
May Gun High Tough Fit	Make A Night Of It
Inn Tooth Hen Heir	Into Thin Air
Europe Lay Sore Mind	Your Place Or Mine
Check Enough These He	Chicken Of The Sea
Abe Who Beat Wrap	A Booby Trap
Ewe Han Mag Ray Gore	Ewan McGregor
Hoop Side Hid Ditto Ken	Oops I Did It Again
Mine Ore A Teary Port	Minority Report
Rot Into Thick Oar	Rotten To The Core
Thesis Sawn Who Tomb He	This Is All New To Me
Thy Pup Dispelled Chews	Wipe Up The Spilled Juice
Thief Wrench Con Eggs Shun	The French Connection
Sea Yule Hater	See You Later
Old Sunned Wins	Olsen Twins
Manner Four	Man-Of-War
Who Why Inn Sir Fur	Hawaiian Surfer
Fun Ella Eyes	Vanilla Ice
Deep Rinse Soft Ides	The Prince Of Tides
Hay Tease Hicks	Eighty-Six
Jeweler Rob Hurts	Julia Roberts
Minnie Soda Vie Kinks	Minnesota Vikings
Seal Indy Yon	Celine Dion
Thigh Sing Gone Thick Ache	The Icing On The Cake
Why Emcee Hay	Ymca
Theme Are Ink Ore	The Marine Corps
Poise Tomb Hen	Boys II Men
Mar Thus Do Hurt	Martha Stewart
Duck Turd Ray	Dr. Dre
Gown Tink Rows	Counting Crows
Hum Eric A Nair Lions	American Airlines
May Cuss Suck Jest Chin	Make A Suggestion
Par Keens Pace	Parking Space
Rome He Owe Hand Jewelry Yet	Romeo And Juliet
Thief Han Tomb Hen Is	The Phantom Menace
Wide Hidden Chews Haze Hoe	Why Didn't You Say So?
Tap Lloyd Noose Pay Purse	Tabloid Newspapers
Fee Nicks Huns	Phoenix Suns
Hit Stoop Add	It's Too Bad
May Churl Eek Bays Paul	Majore League Baseball
Poe Little Key Ink Oar Wrecked	Politically Incorrect
Sue Purse Eye Smee	Super Size Me
Wall Come Island Mash Ooze	Walk A Mile In My Shoes
Pen Silly Raise Her	Pencil Eraser
June Hoe Hull Ask Her	Juneau, Alaska
For Dee Hay Towers	48 Hours
Deep Each Poise	The Beach Boys
Easel Aid Ease Man	He's A Ladies Man
Hoe Min Proof Mint	Home Improvement
Mash Who Sun Tide	My Shoe's Untied
Prints Jar Else	Prince Charles
Toy Ordor Terse Sell	Toyota Tercel
Wren Tough Id He Owe	Rent A Video
Syrup All Mick Are Knee	Sir Paul McCartney
Pick Sin Herb Lank Hit	Pigs In A Blanket
Mayor Itch Maiden Evan	Marriage Made In Heaven
Hint A Few Width Diva Umpire	Interview With The Vampire
Dust Herb Ink Dap Peas	Disturbing The Peace
Ace Heck Hunch Ants	A Second Chance
Disguise Office Raw Car	This Guy's Off His Rocker
Hype Ledger Legions Tooth Affleck	I Pledge Allegiance To The Flag
Mist Hers Myth Ghost Hooha Shint Un	Mr. Smith Goes To Washington
Thief Hearse Late He	The First Lady
Reese Urchin Deep Element	Research And Development
Ohm They Eaters Hiss Dumb	Home Theater System
Lei Deem Harmer Laid	Lady Marmalade
Hoe Pin-Up Hits Depot Lease	Open Up! It's The Police
Abe Hype Rod Duck	A By-Product
Duet Tomb He Juan Mort I'm	Do It To Me One More Time
Heal Heck Trick Have A New	Electric Avenue
Jeep Herb High Deed Doesn't	Cheaper By The Dozen
Nose Sects Beef Form Air Itch	No Sex Before Marriage
Say Fit Fray Ray Need Hey	Save It For A Rainy Day
Thesis Tine Alt Hap	This Is Spinal Tap
Who Terse Arrest Runt	Hooters Restaurant
Theme Anne Jury Ink Candied Ate	The Manchurian Candidate
Plea Sleeve Amass Itch	Please Leave A Message
Aim Adder Rough Open Yen	A Matter Of Opinion
Dough For Ella Wear	Dover, Delaware
Go Form Hints Pending	Government Spending
House The Why Funk Heads	How's The Wife And Kids?
May Lord Herb Ride	Mail-Order Bride
Own Late Aches Aim Men Hit	Only Takes A Minute
Print Says Fee Owner	Princess Fiona
Theme Hag Niftycents Heaven	The Magnificant Seven
Were That Sway Ten Cold	Worth Its Weight In Gold
Ape He Street He	A Peace Treaty
Fee Numb He Nun	Phenomenon
Hit Snotty Fin Clothes	It's Not Even Close
Mash Who'll Aces Sun Tide	My Shoelace Is Untied
Plea Center Europe As Ward	Please Enter Your Password
Stow Vet Hop Tress Sing	Stove Top Dressing
Wall Turk Wrong Height	Walter Cronkite
Murry Ash Rye Fur	Maria Shriver
Jaw Jar Arm I'm Hind	Georgia On My Mind
Fooled Forth Halt	Food For Thought
Ace Cam Mar Test	A Scam Artist
Far Therm Her Fee	Father Murphy
Hit Spin Could Form He	It's Been Good For Me
Mass Car Aid Caws Tomb	Masquerade Costume
Sea Can't Higher Dove Fit	Sick And Tired Of It
You Taj As	Utah Jazz
Fum Geyser Bay Bees	Some Guys Are Babies
Poke Hoe Haunt Is	Pocahontas
Mass Turk Hard	MasterCard
Huge He Nora Gun	Eugen, Oregon
Eight Roost Oar He	A True Story
Ache Inks High Sped	A King-Size Bed
Dock Terse Oar Duhs	Doctor's Orders
Ha Leap Air He	Halle Barry
Wart Rope Mel Funk Shun	Wardrobe Malfunction
Fan Ill Ass Guy	Vanilla Sky
Oozer Fray Duff Deep Pig Pad Woof	Who's Afraid Of The Big Bad Wolf?
Gnu Your Crance Jess	New York Rangers
Hype Bleed Dinner Scen	I Plead Innocent
Mike Robe Rue Hurry	Microbrewery
Rye Terse Gramp	Writer's Cramp
Toe Runt Hoke Annie Duh	Toronto, Canada
Ace Height Force Oar Rise	A Sight For Sore Eyes
Disco Pierre Knead Stoner	This Copier Needs Toner
Foal Jazz Cough He	Folgers Coffee
Huh Fugue Hood Aim In	A Few Good Men
Med Rows Hex Yule	Metrosexual
Rye Ants Eek Rest	Ryan Seacrest
Toy Lit Issue	Toilet Tissue
Silly Cohen Imp Lance	Silicone Implants
Nope Are Kings Own	No-Parking Zone
Ditch Chews Haze Hum Thin	Did You Say Something?
Bed Chirp Autumn Doll Her	Bet Your Bottom Dollar
Eggs Tour Men Hater	Exterminator
Dawn Alt Rump	Donald Trump
Furs Dumb End Mint	First Amendment
Inter Tenement Who Knight	Entertainement Tonight
Oar He Oak Hooky	Oreo Cookie
Srobe Bury Sink Ream	Strawberries And Cream
Urine Mice Pays	You're In My Space
We Eared Sigh Ants	Weird Science
Swedes Hicks Dean	Sweet Sixteen
Patch Jell Earp Arty	Bachelor Party
Know Whiff Fans Herb Huts	No Ifs, Ands Or Buts
Dock Door Rat Kin Sty Hit	Dr. Atkins Diet
Foyer Ape Roof Hall	For Your Approval
Ander Say Weigh	Anchors Away
Eye Pillow Fizz Sigh	Apple Of His Eye
Dock Turf Ill	Doctor Phil
Hike Hen Sit Hen Year Rise	I Can See It In Your Eyes
Eel Heck Trick Are	Electric Car
Debt Snot Must Aisle	That's Not My Style
Ewe Call Lip Dust Re	Eucalyptus Tree
Hun Fork If Hen	Unforgiven
Pen Hokey Yo	Pinocchio
Thine Terse Tate	The Interstate
Wore Inn Buff It	Warren Buffett
Theme Odds Quad	The Mod Squad
Ohm Moo Fees	Home Movies
Lee Gals Sighs End Fell Hope	Legal-Size Envelope
Chest Mice Eyes	Just My Size
Heaven Iced Hey	Have A Nice Day
Dark Turf Rank Inns Tyne	Dr. Frankenstein
Ski Kneed Hip	Skinny Dip
When Owner Hider	Winona Ryder
Send Drab Hull Hock	Sandra Bullock
Eye Shoddy Cher If	I Shot The Sheriff
Inns Hick Nissan Din Elf	In Sickness And In Health
Neigh Jerk Halls	Nature Calls
Rye Sorrow Knee	Rice-A-Roni
Uphill Love Height	A Pillow Fight
You Shore New Dull	Use Your Noodle
Fry Fin Moo Fee	Drive-In Movie
Gel Hope Put Ink	Jell-O Pudding
Juan Inner Meal Yawn	One In A Million
Moo Verse San Jake Hearse	Movers And Shakers
Polar Ab Duel	Paula Abdul
Rubber Toe Benny Knee	Roberto Benigni
Tocke Turd Duel Hit Hell	Dr. Dolittle
Sigh Goes Home Attic	Psychosomatic
Owe Four Rent Dull Gent	Overindulgent
Donut Hawk Twos Train Jazz	Do Not Talk To Strangers
Bick Ma Nun Cam Puss	Big Man On Campus
Ache Hay Solve Cons Tip Asian	A Case Of Constipation
Dawn Biafra Eight Duff Deed Arc	Don't Be Afraid Of The Dark
Flaw Coughs He Gals	Flock Of Seagulls
Hun Dray Ditch High Ant	Ander The Giant
Neck Stayed Eel If Furry	Next-day Delivery
Sick Steamy Knits	Sixty Minutes
Tray Dirge Hose Mar Kit	Trader Joe's Market
Was Acre Heap	What A Creep
Theme Eye Dust Hutch	The Midas Touch
Pair En Tlc Hun Trolls	Parental Controls
Aid Are Crank Loud	A Dark Rain Cloud
Dish Harp Her Rim Edge	The Sharper Image
Ease Cot Loaf Vandals	He's Got Love Handles
Deal If Hurray Yule Edgy	Deliver A Eulogy
Door Her Tex Pull Horror	Dora The Explorer
Aid Hym Pulled Gin	A Dimpled Chin
Hock Doe Us Tent Hackles	Octopus Tentacles
Dewy Half Aid Eel	Do We Have A Deal?
Ale Hum Pen Moth Wrote	A Lump In My Throat
Four End Hick Tater	Foreign Dictator
Lawn Hoarder	Law & Order
Pen Hey Mach Annul	Panama Canal
Toe Runt Hope Luge Hays	Toronto Blue Jays
Who Dion Dipple Oafish	Hootie & The Blowfish
Show Curd Add He	Sugar Daddy
Oz Car Dealer Wren Duh	Oscar De La Renta
Hit Tap End Juan Height	It Happened One Night
Dun Chewbacca Note Art Aim	The Hunchback Of Notre Dame
Hairy Putter Randy Saucer Is Tone	Harry Potter And The Sorcerer's Stone
Misery Reverb Oat	Missouri River Boat
Shy Knees Zack Coupon Sure	Chinese Acupuncture
Wire Ewe Hanoi Ink Mi	Why Are You Annoying Me?
Asbestos Hik Ann	As Best At I Can
Gold Lie Ache Height	Go Fly A Kite
Lair Fink Gout Lout	Laughing Out Loud
Pea Sank White	Peace And Quiet
Theo Rye Leaf Actor	The O'Reilly Factor
Wheel Fair El	Will Ferrell
Purse Annulled Rain Her	Personal Trainer
Hell End Itch Generous	Ellen DeGeneres
Hen Descent Pro Pose Hall	Indecent Proposal
Sex Tea Forth Hows End Hollers	Sixty-Four Thousand Dollars
Tock Toothy And	Talk To The Hand
Call Infer Hell	Colin Farrell
My Cold Hug Lass	Michael Douglas
Stub Her Neigh Same Yule	Stubborn As A Mule
Aim Hilly Hindu Juan	A Million To One
Hiney Duck Hiss	I Need A Kiss
Joke Hocker	Joe Cocker
Tack Seed Rye Fur	Taxi Driver
Yell Hope Hey Jess	Yellow Pages
Ray Dot Che Leap Hep Hearse	Red Hot Chili Peppers
Juan Ow Arf Hoe Toe	One-Hour Photo
Dawned Hutch Mi	Don't Touch Me
Drew Thawed Air	Truth Or Dare
Matter Bow Chew	Mad About You
Thor Ease Hack Grout	Three's A Crowd
Vowel Hint I'm Stay	Valentine's Day
Math Hue Bra Derrick	Matthew Broderick
Fur Stings Versed	First Things First
Bach Sirs Orb Reefs	Boxers Or Briefs
Huge Act Men	Hugh Jackman
Window Wheeze Tart	When Do We Start?
Hgh Yam Knot Ache Rook	I Am Not A Crook
Purse Hun El Lads	Personal Ads
Crate Boss Huff Higher	Great Balls Of Fire
He'll Air Reed Huff	Hilary Duff
Beau Tock Sin Check Shuns	Botox Injections
Lay Turd Who'd	Later Dude
Police Comma Kin	Please Come Again
Wish Shallow Fork Hum	We Shall Overcome
Plea Sack Chore Rage	Please Act Your Age
Cough He Anchor Ream	Coffee And Cream
Bee Keen He Wacks	Bikini Wax
Airy Ledges Purse Sun	A Religious Person
Play Sure Adhere	Place Your Ad Here
You Hess Ascend Her Prize	U.s.s. Enterprise
Pea Cub Who Icyy Hue	Peek-a-boo! I See You!
Ghetto Low Duff Vim	Get A Load Of Him
Aid Hull Tent Tour Tame Mint	Adult Entertainment
Hen Dean Apple Us	Indianapolis
Thread Craws	The Red Cross
Link Hun Ebb Brass Car	Lincoln, Nebraska
Hat Land Tough All Cons	Alanta Falcons
Law Duff There Inks	Lord Of The Rings
Pry Damp Ray Chewed Hiss	Pride And Prejudice
Theme Hum He Reed Urns	The Mummy Returns
Wide Own Shoe Seamy Hen Amour	Why Don't You See Me Anymore?
Ands Inure Pans	Ants In Your Pants
Dick's Each Hicks	Dixie Chicks
Henna Ream Antsy Knee	Henry Mancini
Seuss Hens Aaron Den	Susan Sarandon
Test Brit How Survives	Desperate Housewives
Hey Once Takes Hoss	A1 Steak Sauce
Lit Told Hid High No	Little Did I Know
Theme Anne Aisle Of	The Man I Love
Dew Wino Hue	Do I Know You?
Hive Ale Ding Leash	I Failed English
Mare Retile Armor	Mary Tyler Moore
Thief Wrench Jeff	The French Chef
Wreck Yule Arc Off He	Regular Coffee
Sayer Hutches Hiccup Ark Her	Sarah Jessica Parker
Hive Kotter Bran Nookie	I've Got A Brand New Key
Cat Chum Seas	Catch Some Z's
Hula Deed Hogs Ow	Who Let The Dogs Out?
Neighbors Coat Risk Hits	Nabisco Triscuits
Toe Knee Rant All	Tony Randall
Star Pore Aisles Hoot	Stop Or I'll Shoot!
Mercy Dee Spends	Mercedes-Benz
Egg Hut Tree Hack Shin	A Gut Reaction
Hit Sun Owe Bulk Halls	It's A Noble Cause
Likc Wit Ditch Urge Hint	Liquid Detergent
Super Whom Odors	Subaru Motors
Why Pure Fee Don Deem Hat	Wipe Your Feet On The Mat
Sects Santa Sea Tee	Sex And The City
Dues On Hurry Zone Air	Tuscon, Arizona
Hell Beau Soft Teat Able	Elbows Off The Table
Dungeons Hun	Don Johnson
Knee Says Sand Nay Fuse	Nieces And Nephews
Sex Degrease Offs Hep Oration	Six Degrees Of Separation
Wekk Ant Me Tan Amour	We Can't Meet Anymore
Shade Hap Ink Its Myth	Jada Pinkett Smith
Eye Bend Ream Enough Few	I've Been Dreaming Of You
Hen Fear He Ore Teak Hum Plaques	Inferiority Complex
Eye Hefty Rye Dancers	I Have The Right Answers
Sex Team In Huts	Sixty Minutes
Witch He Talk Anne Sass	Wichita Kansas
Ohm Oar Gauge	Home Mortgage
Eye Avenue Hat Etude	I Have A New Attitude
Apart Rid Chin-Up Hair Tree	A Partridge In A Pear Tree
Lawn Guy Lend Diced He	Long Island Iced Tea
Wisher Duff Aahs!	Wizard Of Oz
Med Hah Sink Hound He	Madison County
Apa Lay Onwards	A Play On Words
Lewd Ache Wrist	Ludicrous
Spy Term Han	Spiderman
Dale He Noose Pay Paw	Daily Newspaper
Les Mecca Dill	Let's Make A Deal
Dawn Neats Tan Ding Hup	Don't Eat Standing Up
Row Mitt Ellie	Rome, Italy
Pie Rate Softy Car Hip Been	Pirates Of The Caribbean
Dub Helen Dam Knee Tee	Double Indemnity
Peal Oaf Height	Pillow Fight
Ape Peep Pulp Her Sun	A People Person
Foyer Inn Form Hay Shun	For Your Information
Verge Chin Nair Lions	Virgin Airlines
Deep Hatch Hell Oar Rhett	The Bachelorette
Raid He Owe Wack Tiff	Radioactive
Who Juan Stubby Aim Hill Yon Hair	Who Wants To Be A Millionaire?
Moo Hammer Dolly	Muhammad Ali
Up Racked Hick Gulch Oak	A Practical Joke
Watt Senate Form He	What's In It For Me?
I'm Ill Yon Dull Hers	A Million Dollars
Won Tube Huck Elm Ice Hue	One, Two, Buckle My Shoe
Lay Tea Tall Hank Gout	Let It All Hang Out
Pa Pie These Hail Herman	Popeye The Sailor Man
Ease Gun Hay Wall	He's Gone AWOL
If Fairy Witch Weigh Bottle Ooze	Every Which Way But Loose
Hive 'zine Delight	I've Seen The Light
Tanks Ford Deem Emma Reese	Thanks For The Memories
Eek Whole Eye Back Teary Aah	E.Coli Bacteria
Mile Hit Hlep Oh Knee	My Little Pony
Her Bra Cadaver	Abracadabra
Halo Garbo Hide Rate Man You	A Low-Carbohydrate Menu
If Reap Potty Loafs Ray Mound	Everybody Loves Raymond
Eggs Rave Fish Hun	X-Ray Vision
Woodchick Aire Force Hum Oar	Would You Care For Some More?
Jaw Jan Law Rob Whoosh	George And Laura Bush
Have Thief Honey Skidding Their	Half The Fun Is Getting There
Twin Team Yule Deem Bore Hacks	20 Mule Team Borax
Share Oak Heat Ripe	Cherokee Tribe
Lie Fizz Booty Fell	Life Is Beautiful
Patch Aah Mop Heart Ease	Pajama Parties
Kay Belt Ella Fission	Cable Television
Sandy Egg Coach Arch Hearse	San Diego Chargers
Hammer Sunned Hot Calm	Amazon Dot Com
Shack Each Anne	Jackie Chan
Meaty Pair Ants	Meet The Parents
Sell My High Yak	Selma Hayek
Shell Seek Lint Hun	Chelsea Clinton
Finned Easel	Vin Diesel
Unique Waters Forth Ease Lots	You Need Quarters For The Slots
Wendy's Ain'ts Comb Arch Ink Hen	When The Saints Go Marching In
Feel Hicks Hunger	Felix Unger
Ladle Rut Writing Good	Little Red Riding Hood
Theme Ease Else	The Measles
Hal In Knifers Hun	Allen Iverson
Hang Herman Itch Mint	Anger Management
Hive Bin Gunnel Lung Thyme	I've Been Gone A Long Time
Wok Lie Canny Chip Shun	Walk Like An Egyptain
Seek You're It Heap Lank Kit	Security Blanket
Dunce Wet These Malt Inks	Don't Sweat The Small Things
Oz Trail Ian Axe Scent	Australian Accent
Hen Reek Hay He Clay See As	Enrique Iglesias
Hire Are Hey Yak Ounce	IRA Accounts
Thread Why Tanned Blew	The Red, White And Blue
Dumb Bees Hutch Hay New Cents	Don't Be Such A Nuisance
Tad Dozen Peru Vanna Ting	That Doesn't Prove Anything
Wine Hot Common Upon Seamy	Who Not Come On Up And See Me?
Hummer I Can Graph Heat He	American Graffiti
By Chore Dung	Bite Your Tongue
Wreck Create Shun Halve He Hackle	Recreational Vehicle
Welk Hum Ohm	Welcome Home
Mace Ease Sand Blue Mink Tails	Macy's And Bloomingdale's
Pill League Oat	Billy Goat
Canoe Key Pace He Grit	Can You Keep A Secret?
Wide Ooh Youth Ink Aisle Of View	Why Do You Think I Love You?
Few Daunt Nome He Pine How	If You Don't Know Me By Now
Putt Meow Tough Mimie Missouri	Put Me Out Of My Misery
Chess Stink Ace	Just In Case
Police Beep Reef	Please Be Brief
Debt Score Wrecked	That's Correct
Cry Shape Hearty	Crash A Party
Gleeful Ann Dough High Owe	Cleveland, Ohio
Ow Don Allege	Out On A Ledge
Weenie Toot Hawk	We Need To Talk
Fit He Owes Door	Video Store
Eel Him Herd Eight	Elimidate
Whence Dane Height	Wednesday Night
Rim Him Birth Owl Limo	Remember The Alamo!
Weirdo Youth Ink York Owing	Where Do You Think You're Going?
Dan Sink Wean	Dancing Queen
Fray Deep Rinse June Your	Freddie Prinze Jr.
Water Hue Tall Kennel Bout	What Are You Talking About?
Ditch It Talc Able	Digital Cable
East Heart Edit	He Started It
Korea Count Seller	Career Counselor
Noggin Hock Ooze Their	Knock! Knock! Who's There?
Putty Stale Beet Weenies Legs	Put His Tail Between His Legs
Win Ermine Loaf Saw Womb Hen	When A Man Loves A Woman
Thief Emily Chew Hills	The Family Jewels
Tunnel Drums Felt	Donald Rumsfield
Petty Cue Her	Pedicure
Mess Achoo Set Spay Come Penny	Massachusetts Bay Company
Thief Hull Mound He	The Full Monty
Mine Hey Miss Pond	My Name Is Bond
Lore Deaf Immerse He	Lord Have Mercy
Thud Hen Verb Wrong Goes	The Denver Broncos
Shah Nigh At Wane	Shania Twain
Key Yak Hum Ford Inner	Can You Come For Dinner?
Might Beef Hat Creek Wet Ink	My Big Fat Greek Wedding
Toe Dewitt's Bra Kit	Toad The Wet Sprocket
Saul Sam Who Sick	Salsa Music
Lapper Door Eat Reverse	Labrador Retrievers
Owe Marsha Reef	Omar Sharif
Thumb Worth Hum Hairier	The More The Merrier
Ma'am Fizz Tenor Sea	Memphis, Tennessee
Lie Berry Off Cone Grass	Library Of Congress
Justice Hymn Pull Reek West	Just A Simple Request
Knell Leaf Hurt Ad Doe	Nelly Furtado
Peat Urge Axe On	Peter Jackson
Ice Peed Gun Hex Shun	High-Speed Connection
Uke Ant An Dell Tat Ruth	You Can't Handle The Truth
Knock Seamer Low Shun	Noxzema Lotion
Owe Pencil Lease	Open Slowly
Hit Saw My Fought	It's All My Fault
Throw Bread Ray Source	Thoroughbred Race Horse
Ewe Nigh Ted Kink Dumb	United Kingdom
Seen Your Sit Haze Hens	Senior Citizens
Lack Docent Holler Rent	Lactose Intolerant
Toe Neath Eat Hiker	Tony The Tiger
Hocks Verdict Shun Airy	Oxford Dictionary
High Den Tee Teeth Heft	Identity Theft
Sigh Code Ram Aah	Psycho-Drama
When Hurt Ache Saw	Winner Takes All
Hint Earn Hall Rougher New Sir Face	Internal Revenue Service
Wish Hood Oven Own	We Should Have Known
Lie Summon Alley	Liza Minnelli
Hoe Megan Hum Ex	Home Economics
Sis Coke Hid	Cisco Kid
Her Rome Math Error Pee	Aromatherapy
Tote Ali Calypso Thee Art	Total Eclipse Of The Heart
Tis Coal Eighty	Disco Lady
Lay Deem Hay Donner	Lady Madonna
Hiawatha Dean Edge Van Pyre	I Was A Teenage Vampire
Hen Amy Of Deep He Pole	Enemy Of The People
Noose Pay Per Heap Hoarder	Newspaper Reporter
Wee Thou Tap Addle	Without A Paddle
Hay Oh Welt I'm War Nor	Aol Time Warner
Gun Treat I'm Lum Inn Eight	Country Time Lemonade
Stay Fence Peel Perc	Steven Spielberg
Peg Issue Gut Mare Heed	Peggy Sue Got Married
Hallow Meat Ooh Bayou Aid Rink	Allow Me To Buy You A Drink
Dew Cough Oil	Duke Of Earl
Fee Sack Hard	Visa Card
Has Skinny Won	Ask Anyone
Phil Matt Eel Heaven	Film At Eleven
Mount Hen Lie Inn	Mountain Lion
Eggs Dream Ache Oh Fur	Extreme Makeover
Hoe Pew Heaven Ice Hummer	Hope You Have A Nice Summer
Weep Ring Hood Thins Tool I've	We Bring Good Things To Life
Moe's Art	Mozart
Noose Pay Purse Tanned	Newspaper Stand
These Pie Ooze Hag Dummy	The Spy Who Shagged Me
Nag Rough Halls	Niagara Falls
Poor Toe Reek Hoe	Puerto Rico
Mack Her Owe Knee Inch He's	Macaroni And Cheese
Ease Oh Emmy Chewer	He's So Immature
Loaf Meat Hinder	Love Me Tender
Watt Half Weak Hot Tool Ooze	What Have We Got To Lose?
Mack Swell Louse Cough He	Maxwell House Coffee
Eye Yam Thug Ray Test	I Am The Greatest
My Crow Sir Jury	Microsurgery
Delgihts Haven Dime	Daylight Savings Time
Hump Teed Ump Tee	Humpty Dumpty
Goat Threw Them Oceans	Go Through The Motions
Bat Chill Harp Hearty	Bachelor Party
Oath Hats Discus Ding	Oh Thats Disgusting
Caress Tough Irk Hull Hum Bus	Christopher Columbus
Tan Cue Fort Aching Mike Hall	Thank You For Taking My Call
Pooh Teal Is Shush	Bootylicious
Canoe Key Pit Who Years Elf	Can You Keep It To Yourself?
Quack Her Hole Heed Hip	Guacamole Dip
Wet Knee Ewes Ten	Whitney Houston
Moth Hearse Hay	Mother's Day
Asp Pink Holler Otto	Aspen, Colorado
Peel Hoe Half Her Itch	Below Average
Feel Licks Thick Hat	Felix The Cat
Wand Her Womb Hen	Wonder Woman
Musky Toe Reap Hell Ant	Mosquito Repellant
Avert Jewel Reel Alley Tee	A Virtual Reality
Whole League How	Wok Lie Canny Chip Shun
Nor Tee Horn Ice	Naughty Or Nice
Bay Beak Hot Bach	Baby Got Back
Hug Tomb Eye Ed	You Go To My Head
Prey Tee Womb Anne	Pretty Woman
Poe Lease Deep Heart Mint	Police Department
Howdy Vest Fuzz Juan	How The West Was Won
Dawned Ease Mi	Don't Tease Me
Pay Perk Lips	Paper Clips
Raw Key Row Die Scream	Rocky Road Ice Cream
Jewel Us Seize Her	Julius Ceasar
Bee Foreign Halved Her	Before And After
He-Man Seep Pay Shun	Emancipation
Ma Neat Inks Hark	Man-Eating Shark
Tin Purse Scent Desk Hound	Ten Percent Discount
Too Niece Oprah Know	Tony Soprano
Hen Day Anna's Date	Indiana State
Height Whole Chews Hoe	I Told You So
Fee Henna Walls Moo Sick	Wienna Waltz Music
Pen Elope Eek Rues	Penelope Cruz
These Ant Are Claws	The Santa Clause
Sit Ease Lick Hearse	City Slickers
Mike Arson Dish Hop	My Car's In The Shop
Grin Etch Fell Itch	Greenwich Village
Henna He Bawdy Their	Anybody There?
Eye Mull Of Mush Sheen	I'm A Love Machine
Rube Hens Dud Hard	Ruben Studdard
Knick Hulk Hid Men	Nicole Kidman
Use Mel Could	You Smell Good
Lew Eve Falcon Duck He	Louisville, Kentucky
Ape Hack Awful Eyes	A Pack Of Lies
Lawn Gopher Do	Long Overdue
Ow Tough Sequins	Out Of Sequence
Won Hunt Dread Hollers	One Hundred Dollars
Sock Herb Hauls	Soccer Balls
Lat Stool Hunch	Let's Do Lunch
Eighty Part Mints Tore	A Department Store
Eyes Cool Valley Dick Tour He An	High School Valedictorian
Lock Sand Bay Gulls	Lox And Bagels
Stow Len Key Says	Stolen Kisses
Width Ought Eight Rays	Without A Trace
Pooh Seek Hats	Pussycats
Loaf Verse Try Ankle	Lover's Triangle
Grist He Gnaw Aggie Lair Her	Christina Aguilera
You Knee Copper Two Needy	Unique Opportunity
Rap Hun Sell	Rapunzel
Law San Jail Lust Dimes	Los Angeles Times
A Taco Think Loans	Attack Of The Clones
Than Cue Button Hoe	Thank You
Hugh Knigh Teds Dates	United States
Hefty Chew Fit Swear Hit	If The Shoe Fits, Wear It
Elm Hack Fairs Hun	Elle MacPherson
Run Held Ray Gun	Ronald Reagan
Wad Abe Hummer	What A Bummer!
Some Hero Limp Hicks	Summer Olympics
Noose Raid He Owe	News Radio
Hun Fork Kit Table	Unforgettable
Eggs Cape For Mal Cat Razz	Escape From Alcatraz
Some Ark Amp Ounce Yule Air	Summer Camp Counselor
Toe Beam Hack Wire	Tobey Maguire
Raw Node Mick Dawn Alt	Ronald McDonald
Donut Hoe Pin Beef Fork Wrist Mess	Do Not Open Before Christmas
Huh Vanna Cue Bah	Havana Cuba
Row Man Call Lease He Hem	Roman Coliseum
Why Tell Infants Ale	White Elephant Sale
Mare Reap Hop Inns	Mary Poppins
Bar Brushed Rise Hand	Barbra Streisand
Freez Ham Pulse	Free Samples
Arrest Mike Ace	I Rest My Case
Thirst Hay Even Ink	Thursday Evening
Wad Abe Hunch Off Nuns Hence	What A Bunch Of Nonsense
Pa Tricks Too Ward	Patrick Stewart
Huh Mere Eye Can Eye Dull	American Idol
Abe Hold Faye Sly	A Bold-Faced Lie
Guy Oaty Hug Lee	Coyote Ugly
Aisle Me Chew Have Weigh	I'll Meet You Halfway
Tempo Might Hung	Tip Of My Tongue
Nod Itch Ants	Not A Chance
She Can Catch A Tory	Chicken Cacciatore
Knot Joe Geeze	Nacho Cheese
Earl Eat Tibet Earl Eat Who Rice	Early To Bed Early To Rise
Hoover Aimed Raw Cheer Habit	Who Framed Roger Rabbit?
Pub Lick Ewe Till Itty	Public Utility
We Shy Worth Hare	Wish I Were There
Play Sings Add Dells	Blazing Saddles
High Wetness Snooze	Eyewitness News
Abe Earth Daze Hoot	A Birthday Suit
Hat Ten Shunned Deaf Asset Tis Hoarder	Attention Deficit Disorder
Nest Leak Grunge Jabar	Nestle Crunch Bar
Toe Tall Gun Few Shun	Total Confusion
Up Hound Hug Round Round	A Pound Of Ground Round
Oh Firm Hide Head Potty	Over My Bead Body
Hoe Moth Herb Rave	Home Of The Brave
Eye Mile Tough Guess	I'm Out Of Gas
Us Candle Us Of Hair	A Scandalous Affair
Owe Nat Chore Al	Au Natural
Jar Leash Ian	Charlie Sheen
Sheik Cons Hoop Fur Thistle	Chicken Soup For The Soul
Sex Feed Hunter	Six Feet Under
Half Freight Tough Deed Arc	Afraid Of The Dark
Eel Is Bath Early	Elizabeth Hurley
Deer Leap Heel Hovered	Dearly Beloved
Shoe Gird Hone Huts	Sugar Donuts
Thrill My Coy	The Real McCoy
Shatter Nougat Any Sea	Chattanooga, Tennessee
Mare Eek Ate Danish Lee Hole Sin	Mary-Kate And Ashley Olsen
Her Wreath Of Rank Lynne	Aretha Franklin
Dew Placate Prince	Duplicate Prints
Thesis Nope Lace Furl Eighty	This Is No Place For A Lady
These Oop Ream Kurt	The Supreme Court
Nativity Merry Cans	Native Americans
Fatty Cans Itty	Vatican City
Ghetto Four Abe Row Can Art	Get Over A Broken Heart
Dry Fink Mist Hazy	Driving Miss Daisy
Minnie Sew DAT Wins	Minnesota Twins
Pull Ease Clothes Theodore	Please Close The Door
Thug Yet His Burger Dress	The Ghettysburg Address
You Rowed His Knee	Euro Disney
Spar Cling What Her	Sparkling Water
Nose Moe Kings Own	No-Smoking Zone
Henna Knee Coals Myth	Anna Nicole Smith
Deal If Are Ants	Deliverance
Amos Ooze	A Masseuse
Faye Teller Track Shun	Fatal Attraction
Hive Cot Chew Hun Term Ice Kin	I've Got You Under My Skin
Eye Screams Hand Witch	Ice Cream Sandwich
Eight Hoop Hay	A Toupee
Barbie Cute Rips	Barbecued Ribs
Fur Chins Ray Chords	Virgin Records
Date Roy Pea Stuns	Detroit Pistons
Lit Skit Tone Width Hit	Let's Get On With It
Pull Ease Leaf Mia Lone	Please Leave Me Alone
You Says Dye Erected	Use As Directed
Weigh Cup Toothy Fax	Wake Up To The Facts
Toot Hence Two Ray Lacks	Too Tense To Relax
Puns Offs Teal	Buns Of Steel
Mare Heed Width Chilled Run	Married With Children
Hoe Bra Win Free	Oprah Winfrey
Ewe Hardy Juan Form He	You Are The One For Me
Barfs Hope	Bar Of Soap
Dream Mennen Eight Hub	Three Men In A Tub
Aisle Me Jewel Hater	I'll Meet You Later
Eyeed Ream Oaf Gene He	I Dream Of Genie
Pea Pill Arf Honey	People Are Funny
Win Airy Meds Alley	When Harry Met Sally
Theme Alt Ease Falk Inn	The Maltese Falcon
Nosh Hun Elsie Cure Itty	National Security
Icing Adder Hype Itch	A Sing At A Hight Pitch
Hawk Hidden Us Hide	All Kidding Aside
Ease Iraq Grew Pea	He's A Rock Groupie
Damp Oh Rare Each Hob	Temporary Job
Tree Chores Hail Fright	Treat Yourself Right
Sip Eighty Dude Ha!	Zip-A-Dee-Doo-Dah
Ooze Linus Sit Denny Weigh	Whose Line Is It Anyway?
Kwan Tan Nemo Bake You Bah	Guantanamo Bay, Cuba
Hemp Yule Lance High Wren	Ambulance Siren
Loose Ian Desk Eye Width Dime Hands	Lucy In The Sky With Diamonds
Rub Herb Hey Beep Huggy Bum Purse	Rubber Baby Buggy Bumpers
Juneau Hawaii Filler Bowed Ewe	You Know How I Feel About You
Ear Swan Forth Erode	Here's One For The Road
Aid Eye Mud Us Sin	A Dime A Dozen
Dawn By Chore Fink Earn Ails	Don't Bite Your Fingernails
Elf Red Itch Caulk	Alfred Hitchcock
Few Noose Ooze Hee	If You Knew Susie
Mel Come Eggs	Malcolm X
Safe Hemp Try Fat Try On	Saving Private Ryan
Use Header Moth Fuel	You Said A Mouthful
Weigh Cup Pin Theme Awning	Wake Up In The Morning
Sea Hearse Robe Huck	Sears Roebuck
May Tricks Reel Owe Dead	Matrix Reloaded
Han Dover Theme Honey	Hand Over The Money
Ape Arrows Uncle As His	A Pair Of Sunglasses
Bigger Scant Beach Who Seers	Beggars Can't Be Choosers
Hit Sewn Leap Uphill Of	It's Only Puppy Love
Fell Edge Eddie Hit	Village Idiot
Dutch Egg Cousin Theme Ale	The Check Is In The Mail
Den Eek Hay	Danny Kaye
Dawn Kim Add Kitty Fin	Don't Get Mad, Get Even
Elf Fish Coast Hello	Elvis Costello
Ale Of Huff Air	A Love Affair
My Call Ice Nor	Michael Eisner
Sense Cyst Acres	Census Takers
Wok Aim Aisle Enema Chews	Walk A Mile In My Shoes
Tree Twit Tea Elsie	Treat With TLC
Thick Hearse Soft Eve Umpire	The Curse Of The Vampire
Pair Neck Ed Late He's	Barenaked Ladies
Late Ease Ohm Churn Hal	Ladies' Home Journal
Hemp Heath Reap Layer	MP3 Player
Dye Lem Form Herder	Dial M For Murder
Aid Us Tier Owed	A Dusty Road
Dare Saw Weight Such Ants	There's Always A Chance
Cain Eye Bayou Ade Rink	Can I Buy You A Drink?
Know Awhile He	Noah Wyle
Ray Duh Softy Law Stark	Raiders Of The Lost Ark
Weed Dupe Hay Percolating	We Do Paper Collating
Sigh Cope Ab Bull	Psychobabble
Leaf Meal Own	Leave Me Alone
Hoe Shin Pray	Ocean Spray
Eggs Marx Despot	X Marks The Spot
Dock Terse Ooze	Dr. Seuss
Well Sun Fill Ups	Wilson Phillips
These Hoop Reams	The Supremes
Policed Hymm Delights	Please Dim The Lights
Lore Ants Offer Abe Year	Lawrence Of Arabia
Hit Says Mall Whirled	It's A Small World
Backed Ooze Queer Won	Back To Square One
Key Tan Leap Hold	Kate And Leopold
Thin Hey Muff Thick Aim	The Name Of The Game
Eyes Tink	I Stink
Bra Mutter	Barometer
Arrow Man Tick Calm Eddy	A Romantic Comedy
Fizzy Gal Eggs Ham	Physical Exam
Haul Soft Monty Zoo Ma	Halls Of Montezuma
Lie Sin Sand Dedges Tray Shun	License And Registration
Owed Tube Ill Leech Hoe	Ode To Billie Joe
Shake Key Low Kneel	Shaquille O'Neal
Weaken Worker Hound Debt	We Can Work Around It
Weed Mile Hips	Read My Lips
Sit Chores Height Sigh	Set Your Sights High
Neigh Verse Sane Heifer	Never Say Never
Ice Senate Dew Ewe	I Sent It To You
Gray Can Hear	Greg Kinnear
Around Dove Apple Laws	A Round Of Applause
Elects Hand Earthly Crate	Alexander The Great
Huff Fence If Owl	Offensive Foul
Marry Addle Ladle Am	Mary Had A Little Lamb
Where Tally Hank Of Hick	Weird Al Yankovic
Thief Hearse Touch An You Weary	The First Of January
Root Each Julie Ah Knee	Rudy Giuliani
Mull Teen Ash Annul Fours	Multi-National Force
Juneau Mine Umber	Do You Know My Number?
Duke Hum Mere Off Hen	Do You Come Here Often?
Thirst Aim Awning	Thursday Morning
Theif Hill Art Dell Fee Us Tory	The Philadelphia Story
Sent Drill Hum Eric Aah!	Central America
Pa's Dram Ease Hand Witch	Pastrami Sandwich
My Ham Mead Hole Fins	Miami Dolphins
Junk Airy	John Kerry
Heap Itched Ape Err Fig Came	He Pitched A Perfect Game
Egg Aim Much Egg Curse	A Game Of Checkers
Canned Ache My High Saw Few	Can't Take My Eyes Off You
Paper Own Heap Heats Aah	Pepperoni Pizza
Sink Owed Deem Eye Owe	Cinco De Mayo
Tube Row Tacked Ant Surf	To Protect And Serve
Us It Ease Liquor	A City Slicker
Sigh Ted Fork Un Tempt	Cited For Contempt
Peep Elm Hag Oz Scene	People Magazine
Lay Bird Hey We Kin	Labor Day Weekend
High Wheel Hall Weighs Loaf View	I Will Always Love You
Eye Nay Firm Ache Mist Aches	I Never Make Mistakes
Awe Haze Could Furl Half	Always Good For A Laugh
Hit Sub Pow Dime	It's About Time
Key Pits Imp Pills Too Pet	Keep It Simple Stupid
Nay Home Each Hud	Naomi Judd
Poe Tate Terse Hal Ad	Potato Salad
Sure Lime Hackle Lane	Shirley MacLaine
Up Row Fashion Hulls Beaker	A Professional Speaker
Toe Gap Hearty	Toga Party
Shack Cough Alt Raids	Jack Of All Trades
Nope Odd Den Hose Force Your	Nobody Knows For Sure
Jar Lease There Hawn	Charlize Theron
Floor Eat Dumb Are Lens	Florida Marlins
Knee Go She Ate	Negotiate
New Disc Hollow Knee	Nudist Colony
Row Linen Thumb Honey	Rolling In The Money
Tour Tea Etch Hips	Tortilla Chips
Witch Weighed Hid Ego	Which Way Did He Go?
These Hounds Offs High Lens	The Sounds Of Silence
Paws Iffy Go Shin	Pacific Ocean
Lawn Done Breach	London Bridge
High Weight Who Evan	Highway To Heaven
Dawned Rink Hand Arrive	Don't Drink And Drive
Dub Hell Chap Ore Dee	Double Jeopardy
High Moan Leak Hidden	I'm Only Kidding
Lay Surge Urge Hurry	Laser Surgery
Yore Luke Ink Hood	You're Looking Good
Tot Calm	Dot Com
Sew Fiat Tune Yawn	Soviet Union
Pain Sills Harp Inner	Pencil Sharpener
Lee Gal Heap Lawned	Legally Blonde
Go Tan Hatch Heck	Coat And Hat Check
Chore Chuff Teach Uncle	George Of The Jungle
Was Estrange Lank Wedge	What A Strange Language
Stay Tough Arc Handsaw	State Of Arkansas
Place Day Shun	Playstation
Owe Shins Heel Heaven	Ocean's Eleven
Lee Sack Who'd Row	Lisa Kudrow
Hiss Statue Gnaw King	Is That You Knocking?
Faze Them Hues Sick	Face The Music
Deed At Chew Off Lip Buddy	The Statue Of Liberty
Noose Eel Hand	New Zealand
Reap Lace Mints	Replacements
Thud Era Belt Ooze	The Terrible Twos
Well Yum Shay Kiss Beer	William Shakespeare
Tack Spayer	Taxpayer
Pun Knee Marsh Hull	Penny Marshall
Mack Haul He Can Ken	Macaulay Culkin
Hole Kitten Cup Poodle	Whole Kit And Caboodle
Fur Scum Fur Surfed	First Come First Served
Cur Nells Hand Errs	Colonel Sanders
Haste Huff Danny Mull	A Stuffed Animal
Intern Ash Shun El Tree Tea	International Treaty
Mill Can Goo Keys	Milk And Cookies
Peek Czar Hinder Ten Mint	Pixar Entertainment
Sill Fester Ant We Tee	Slyvester And Tweety
Tie Dull Waif	Tidal Wave
Utah Kin Tomb He	You Talkin' To Me?
Stay Cake Lame	Stake A Claim
Pardon Her Sink Rhyme	Partners In Crime
Law Sand Jealous Lay Curse	Los Angeles Lakers
Hap Rent Dis	Apprentice
Dave Inch Cheek Owed	Da Vinci Code
Bah Kin These Addle Ache Ken	Back In The Saddle Again
Awl Took Hath Earn How	All Together Now
Dutch Mean Them Awning	Touch Me In The Morning
Hiney Duck Holes How Ware	I Need A Cold Shower
Laws Din Trance Lay Shun	Lost In Translation
Nossed Ring Sat Hatched	No Strings Attached
Sent Tom Hanukah	Santa Monica
Ton Love Love	Tunnel Of Love
Chew Ear Thin Ooze	Did You Hear The News?
Hook Hut Ditch Ease	Who Cut The Cheese?
Annie Turn Awful Lame	An Eternal Flame
Since Henna Tea Ojai Owe	Cincinnati, Ohio
Mike Lion Tis Inner Scent	My Client Is Innocent
Hoe Met Quit Heel Hone	Home Equity Loan
Egg Hood Sore Solve Eye Burr	A Good Souce Of Fiber
Thick Hard Enough Heed Hen	The Garden Of Eden
Wheel Yun Air Ream He	Will You Marry Me?
Way Tan Seattle Tude	Wait-And-See Attitude
Teller Aber How Did	Tell Her About It
Peas Dash He Own Huts	Pistachio Nuts
May Cane Aim Foyers Elf	Make A Name For Yourself
Grey Niche Car Net He Quit	Greenwich, Connecticut
Chain Jeff Pays	Change Of Pace
Has Is Tent Men Itcher	Assistant Manager
Tubby Horn Hot Tubby	To Be Or Not To Be
Shy Niece Sheik Anne's Hal Ad	Chinese Chicken Salad
Out Ache Arrow View	I'll Take Care Of You
Mean Are Sin Hue Chain	Me Tarzan, You Jane
Lace Her Ice Serge Hurry	Laser Eye Surgery
Tonier Wards Air Him On Knee	Tony Awards Ceremony
Hay Says Anne Dates	Aces And Eights
Few Own Lean Hue	If You Only Knew
Beak Hall Size Heads Hoe	Because I Said So
These Hound Dan Thief Ewe Re	The Sound And The Fury
Up Arrow Tin Issues	A Pair Of Tennis Shoes
Seethe Rues Rink Crap	See-Through Shrink Wrap
Nome Ore Mist Earn Ice Sky	No More Mister Nice Guy
Just Us Wheel Yam Wren Quest	Justice William Rehnquist
Glassy Fir Dad Fur Ties Mint	Classified Advertisement
Degrease Santa Grate	Degrees Centigrade
Empty Fees Speech Ows	MTV's Beach House
Kenya Sheik Djibouti	Can You Shake Your Booty?
Oz Karma Dis Hun	Oscar Madison
Want Herb Raw	Wonderbra
These Cool Awe Frock	The School Of Rock
Sew Pop Hurrahs Tar	Soap Opera Star
Knee Key Hand Para Silt Hun	Nicky And Paris Hilton
Dame Lurk Rye Seller	Daimler Chrysler
Lie Finch Urine Spa Less He	Life Insurance Policy
Goal Damp Error Shoot	Golden Parachute
Aim Hunk Hear Inch	A Monkey Wrench
Ditch Atoll Cam Hurrah	Digital Camera
Gym Bell Who She	Jim Belushi
Kitten Hurl East Heart	Get An Early Start
My Chem Hires	Mike Myers
Robber Teen Hero	Robert De Niro
Thief Height Glub	The Fight Club
Ache Hunt Trim Aisle	A Country Mile
He Stir Paw Raid	Easter Parade
Thaw My Teed Holler	The Almighty Dollar
Hike Ann Tell Pit	I Can't Help It
Ow Weirds Turn	Howard Stern
Keel Her Beast Ink	Killer Bee Sting
Fee Knicks Harry's Owner	Phoenix, Arizona
Ace Lip Puff That Hung	A Slip Of The Tongue
Tooth Hum Sup	Two Thumbs Up
Wide Hunch Uke Hall	Why Don't You Call?
Toe Reese Cell Ink	Tori Spelling
Seize Hearse Sail Ed	Ceasar Salad
Hairy Sin Fort	Harrison Ford
Mare Reel Inn Man's Hun	Marilyn Manson
Deed Roy Die Guess	Detroit Tigers
He Legs Shunned Hey	Election Day
Vine Ding Knee Moe	Finding Nemo
Soup Herman	Superman
Poise Gout Sofa Merry Car	Boy Scouts Of America
My Crows Off Tex Sell	Microsoft Excel
Lettuce Spray	Let Us Pray
Upper Fig Twirled	A Perfect World
Hits Tan Treason	It Stands To Reason
Gulls Gouts Sofa Mare Eek Her	Girl Scout Of America
Berth Daze Hoot	Birthday Suit
Sham Paint Host	Champagne Toast
Up He Such Ease	A Piece Of Cheese
Swede Boat Eight Dope Eye	Sweet Potato Pie
Paper Fum Ooh Fee	Pay-Per-View Movie
Lee Hone Art Goudh Dove Inch He	Leonardo Da Vinci
Hen Deep Hen Danced Hay	Independence Day
Dents Hell Wars Shin Dun	Denzel Washington
Disguise They'll Him It	The Sky's The Limit
Hum Era Gun Egg Suppress	American Express
Mirror Called Rug	Miracle Drug
Spike Ids	Spy Kids
We Loaf Ore Chin	Wheel Of Fortune
Oz Tin Tech Sass	Austin, Texas
May Kick Wick	Make It Quick
Fair Wren Night	Fahrenheit
My Ham Eve Ice	Miami Vice
Haul Weigh Sewn Mimi Hind	Always On My Mind
Drum Attic Lime Acts	Dramatic Climax
Comet He Affair Hearse	Comedy Of Errors
Ray Sink Air Reese Owner	Raising Arizona
Led Skit Auto Fear	Let's Get Out Of Here
Weep Hay Holes Ale	We Pay Wholesale
Pay Per Row Says	Paper Roses
High Seed Head Pee Pull	I See Dead People
Day Fit Duke Of Knee	David Duchovny
Deed Hay Off Tour Tomb Arrow	Fur Chin Ollie Foil
Varoom Deep Belt Holes	For Whom The Bell Tolls
Tan Needy Fee Toe	Danny Devito
Pop Hair Yahtzee	Paparazzi
Loss Vague Ask Hussy Know	Las Vegas Casino
Nuke Id Sun Deep Lock	New Kids On The Block
Dawned Pea Hugger Limb Ann	Don't Be A Girly Man
Chest Beat Wean Husk Hurls	Just Between Us Girls
You Knee Verse Sails Duty Owes	Universal Studios
Oh Mother Men	Uma Thurman
Lose He An Up Her Chess	Louisiana Purchase
Lee Tell Louse Honda Prayer He	Little House On The Prairie
Match Hick Kate Paul	Magic 8-ball
Skoal Elastic Hap Tee Tude Taste	Scholastic Aptitude Test
Yule Lees Mime Hind	You'll Ease My Mind
Pole Eddy Clicker Wrecked	Politically Correct
Hello Win Dressed Morgue Itch	A Low-Interest Mortgage
Pitchers Heat Bell Town	Put Your Seat Belt On
High Van At Rump	Ivana Trump
Hun Door Hen Easer Come Stan Says	Under Any Circumstances
Neigh Home Eek Amp Bull	Naomi Campbell
Haft Ermine Dun Height	After Midnight
Gay Gummy Width Ace Boon	Gag Me With A Spoon
Dawned Hey Guinea Chants His	Don't Take Any Chances
Eyed Rye Fan Issue Fee	I Drive An SUV
Age Us Dissolved Deep Ease	A Justice Of The Peace
Force Ease Hun Sew Tell	Four Seasons Hotel
Iran Alt Aweigh Ohm	I Ran All The Way Home
Wrist Hush Herd	Rest Assured
Police Collar Dock Tour	Please Call A Doctor
Sin A Men Sure Grr!	Cinnamon Sugar
Cuff Hearse Dory	Cover Story
Chew Lie Thief Oath	July The Forth
Chain Solve Fad Dress	Change Of Address
Ball Stunk Lamp Shouter	Boston Clam Chowder
Bloop Lades Pay Shell	Blue Plate Special
Baby Beef Ace	Baby Face
Bah Fee Theif Amp Hires Layer	Buffy The Vampire Slayer
Ache Hatter Mia Words	Academy Awards
Share Ilk Row	Sheryl Crow
Mile Hip Czars Healed	My Lips Are Sealed
Yule Bizarre He	You'll Be Sorry
Scene Curse Whim	Sink Or Swim
Knee Gull Odie Yon	Nickelodeon
Eight Addled Ale	A Tattle Tale
Essay Madder Rough Act	As A Matter Of Fact
See Chores Elf	Seat Yourself
Pooh Purse Coo Purr	Pooper Scooper
Loaf Hem Anne Leaf Hem	Love 'Em And Leave 'Em
Sheik Hog Hope Airs	Chicago Bears
Reef Hing Off Dean Herds	Half Reed Hummed He Canary
Ewe Hardy We Gus Slink	You Are The Weakest Link
Dawn Beak Rule	Don't Be Cruel
Wad Ape Hair	What A Pair
Portal Ann Dory Gun	Portland, Oregon
Miss Turn High Sky	Mister Nice Guy
May King Gout	Making Out
Oh Gland Ray Tars	Oakland Raiders
Twin Tea Juan Dan Dover	Twenty-One And Over
These Eye Lents Softy Lamps	The Silence Of The Lambs
May Kind Thief Id He Owe	Making The Video
Filler Dell Fee Half Ill Ease	Philadelphia Phillies
Oak Abe Abe	Okay
Able Ink Gun	Abe Lincoln
Dawn Ways Might I'm	Don't Waste My Time
May Cry Inn	Meg Ryan
Gay Teak You're Hick	Katie Couric
Abe Ax Heat Rye Fur	A Back Seat Driver
Awe Mile Of	All My Love
Agree Seize Boon	A Greasy Spoon
Check Cove Fault Raids	Jack Of All Trades
Hive Cot Yearn Umber	I've Got Your Number
Owl Yukon Heat Buff Hay	All You Can Eat Buffet
These Tars Angle Ban Her	The Star Spangled Banner
Par Dummy	Pardon Me
Tour He Aim Hoss	Tori Amos
Dew June Hoe Mine Aim	Do You Know My Name?
Dew Ache Who Gulls Urge	Do A Google Search
Dawn Peek Yearn Hose	Don't Pick Your Nose
Dawn As Hummer	Donna Summer
Call Imp Howl	Colin Powell
Bun Crock Moo Sick	Punk Rock Music
Air Reek Lap Done	Eric Clapton
Ache Wrist Much Air Hull	A Christmas Carol
Ache Hand Helen Dee Win	A Candle In The Wind
